{ 10000, 0x00 },
{ 10000, 0x01 },
{ 10000, 0x02 },
{ 10000, 0x03 },
{ 10000, 0x04 },
{ 10000, 0x05 },
{ 10000, 0x06 },
{ 10000, 0x07 },
{ 10000, 0x08 },
{ 10000, 0x09 },
{ 10000, 0x0A },
{ 10000, 0x0B },
{ 10000, 0x0C },
{ 10000, 0x0D },
{ 10000, 0x0E },
{ 10000, 0x0F },
{ 10000, 0x10 },
{ 10000, 0x11 },
{ 10000, 0x12 },
{ 10000, 0x13 },
{ 10000, 0x14 },
{ 10000, 0x15 },
{ 10000, 0x16 },
{ 10000, 0x17 },
{ 10000, 0x18 },
{ 10000, 0x19 },
{ 10000, 0x1A },
{ 10000, 0x1B },
{ 10000, 0x1C },
{ 10000, 0x1D },
{ 10000, 0x1E },
{ 10000, 0x1F },
{ 10000, 0x20 },
{ 10000, 0x21 },
{ 10000, 0x22 },
{ 10000, 0x23 },
{ 10000, 0x24 },
{ 10000, 0x25 },
{ 10000, 0x26 },
{ 10000, 0x27 },
{ 10000, 0x28 },
{ 10000, 0x29 },
{ 10000, 0x2A },
{ 10000, 0x2B },
{ 10000, 0x2C },
{ 10000, 0x2D },
{ 10000, 0x2E },
{ 10000, 0x2F },
{ 10000, 0x30 },
{ 10000, 0x31 },
{ 10000, 0x32 },
{ 10000, 0x33 },
{ 10000, 0x34 },
{ 10000, 0x35 },
{ 10000, 0x36 },
{ 10000, 0x37 },
{ 10000, 0x38 },
{ 10000, 0x39 },
{ 10000, 0x3A },
{ 10000, 0x3B },
{ 10000, 0x3C },
{ 10000, 0x3D },
{ 10000, 0x3E },
{ 10000, 0x3F },
{ 10000, 0x40 },
{ 10000, 0x41 },
{ 10000, 0x42 },
{ 10000, 0x43 },
{ 10000, 0x44 },
{ 10000, 0x45 },
{ 10000, 0x46 },
{ 10000, 0x47 },
{ 10000, 0x48 },
{ 10000, 0x49 },
{ 10000, 0x4A },
{ 10000, 0x4B },
{ 10000, 0x4C },
{ 10000, 0x4D },
{ 10000, 0x4E },
{ 10000, 0x4F },
{ 10000, 0x50 },
{ 10000, 0x51 },
{ 10000, 0x52 },
{ 10000, 0x53 },
{ 10000, 0x54 },
{ 10000, 0x55 },
{ 10000, 0x56 },
{ 10000, 0x57 },
{ 10000, 0x58 },
{ 10000, 0x59 },
{ 10000, 0x5A },
{ 10000, 0x5B },
{ 10000, 0x5C },
{ 10000, 0x5D },
{ 10000, 0x5E },
{ 10000, 0x5F },
{ 10000, 0x60 },
{ 10000, 0x61 },
{ 10000, 0x62 },
{ 10000, 0x63 },
{ 10000, 0x64 },
{ 10000, 0x65 },
{ 10000, 0x66 },
{ 10000, 0x67 },
{ 10000, 0x68 },
{ 10000, 0x69 },
{ 10000, 0x6A },
{ 10000, 0x6B },
{ 10000, 0x6C },
{ 10000, 0x6D },
{ 10000, 0x6E },
{ 10000, 0x6F },
{ 10000, 0x70 },
{ 10000, 0x71 },
{ 10000, 0x72 },
{ 10000, 0x73 },
{ 10000, 0x74 },
{ 10000, 0x75 },
{ 10000, 0x76 },
{ 10000, 0x77 },
{ 10000, 0x78 },
{ 10000, 0x79 },
{ 10000, 0x7A },
{ 10000, 0x7B },
{ 10000, 0x7C },
{ 10000, 0x7D },
{ 10000, 0x7E },
{ 10000, 0x7F },
{ 10000, 0x80 },
{ 10000, 0x81 },
{ 10000, 0x82 },
{ 10000, 0x83 },
{ 10000, 0x84 },
{ 10000, 0x85 },
{ 10000, 0x86 },
{ 10000, 0x87 },
{ 10000, 0x88 },
{ 10000, 0x89 },
{ 10000, 0x8A },
{ 10000, 0x8B },
{ 10000, 0x8C },
{ 10000, 0x8D },
{ 10000, 0x8E },
{ 10000, 0x8F },
{ 10000, 0x90 },
{ 10000, 0x91 },
{ 10000, 0x92 },
{ 10000, 0x93 },
{ 10000, 0x94 },
{ 10000, 0x95 },
{ 10000, 0x96 },
{ 10000, 0x97 },
{ 10000, 0x98 },
{ 10000, 0x99 },
{ 10000, 0x9A },
{ 10000, 0x9B },
{ 10000, 0x9C },
{ 10000, 0x9D },
{ 10000, 0x9E },
{ 10000, 0x9F },
{ 10000, 0xA0 },
{ 10000, 0xA1 },
{ 10000, 0xA2 },
{ 10000, 0xA3 },
{ 10000, 0xA4 },
{ 10000, 0xA5 },
{ 10000, 0xA6 },
{ 10000, 0xA7 },
{ 10000, 0xA8 },
{ 10000, 0xA9 },
{ 10000, 0xAA },
{ 10000, 0xAB },
{ 10000, 0xAC },
{ 10000, 0xAD },
{ 10000, 0xAE },
{ 10000, 0xAF },
{ 10000, 0xB0 },
{ 10000, 0xB1 },
{ 10000, 0xB2 },
{ 10000, 0xB3 },
{ 10000, 0xB4 },
{ 10000, 0xB5 },
{ 10000, 0xB6 },
{ 10000, 0xB7 },
{ 10000, 0xB8 },
{ 10000, 0xB9 },
{ 10000, 0xBA },
{ 10000, 0xBB },
{ 10000, 0xBC },
{ 10000, 0xBD },
{ 10000, 0xBE },
{ 10000, 0xBF },
{ 10000, 0xC0 },
{ 10000, 0xC1 },
{ 10000, 0xC2 },
{ 10000, 0xC3 },
{ 10000, 0xC4 },
{ 10000, 0xC5 },
{ 10000, 0xC6 },
{ 10000, 0xC7 },
{ 10000, 0xC8 },
{ 10000, 0xC9 },
{ 10000, 0xCA },
{ 10000, 0xCB },
{ 10000, 0xCC },
{ 10000, 0xCD },
{ 10000, 0xCE },
{ 10000, 0xCF },
{ 10000, 0xD0 },
{ 10000, 0xD1 },
{ 10000, 0xD2 },
{ 10000, 0xD3 },
{ 10000, 0xD4 },
{ 10000, 0xD5 },
{ 10000, 0xD6 },
{ 10000, 0xD7 },
{ 10000, 0xD8 },
{ 10000, 0xD9 },
{ 10000, 0xDA },
{ 10000, 0xDB },
{ 10000, 0xDC },
{ 10000, 0xDD },
{ 10000, 0xDE },
{ 10000, 0xDF },
{ 10000, 0xE0 },
{ 10000, 0xE1 },
{ 10000, 0xE2 },
{ 10000, 0xE3 },
{ 10000, 0xE4 },
{ 10000, 0xE5 },
{ 10000, 0xE6 },
{ 10000, 0xE7 },
{ 10000, 0xE8 },
{ 10000, 0xE9 },
{ 10000, 0xEA },
{ 10000, 0xEB },
{ 10000, 0xEC },
{ 10000, 0xED },
{ 10000, 0xEE },
{ 10000, 0xEF },
{ 10000, 0xF0 },
{ 10000, 0xF1 },
{ 10000, 0xF2 },
{ 10000, 0xF3 },
{ 10000, 0xF4 },
{ 10000, 0xF5 },
{ 10000, 0xF6 },
{ 10000, 0xF7 },
{ 10000, 0xF8 },
{ 10000, 0xF9 },
{ 10000, 0xFA },
{ 10000, 0xFB },
{ 10000, 0xFC },
{ 10000, 0xFD },
{ 10000, 0xFE },
{ 10000, 0xFF },

